1111111111111111111111111111111111
10100000000000000000000000000001C1
10100101001000001010010000000101E1
1010010010101010001001000000010101
1P00000000000000000000000000000001
1111111111111111111111111111111111