1111111111111111111111111111111111
10100000000000000000000000000001C1
1010010100110001101001000000C101E1
1010010010101010001111000000110101
1P00000000000000000000000000000001
1111111111111111111111111111111111