111111
1P0001
101111
1C1E01
111111
