111111
1P0C01
111111
1C0001
100E01
111111
